+++++++++++++++++++++++++++++++++++++++++++++++++++
+   +               +   +             +       +   +
+++ + +++++++ +++++ + + + +++ +++++++++ + +++ +++ +
+   +   +     +   +   + +   +     +     +   +     +
+ +++++ + +++++ + +++++ +++++++++ + +++++++ +++++ +
+     + + +   + +   +   +         +   +   +     + +
+++++ +++ + + + + +++ +++ +++++++++++ +++ +++++ + +
+   +   +   + + + +   +   +     +   +   +   +   + +
+ + +++ +++++ + + + +++ + + +++ + + +++ + + + +++ +
+ +   +       + + + +e+ +   + + + +   + + + + + + +
+ +++ +++++++++ +++ + + +++++ + + +++ + + +++ + + +
+ + + +         +   +   +     +   + +   + +   +   +
+ + + + +++++++ + +++ +++++++ +++++ +++++ + +++ +++
+   + +   +   +   +                     + + + + + +
+ +++ +++ + + +++++++++++++++++ +++++++ + + + + + +
+ +     +   +         +         +     +   + +   + +
+ + +++ +++++++++++++ +++++++++++ +++ +++++ + +++ +
+ + +     +         +   +       +   +     + + +   +
+++ + +++++ +++ +++++++ + +++++ +++ +++++ + + + + +
+   + +     +   +     + +   + +     +   +   + + + +
+ +++ + +++++ + + + +++ + + + +++++++ +++++++ + + +
+ +   +   +   + + + +   + + +     +     +   +   + +
+ +++++ +++ +++++ + + +++++ +++ + +++++ + + +++++ +
+ +     +   +     +   +     +   +       + +     + +
+ + +++++ + + +++++++++ +++++ + +++++++ + + +++++ +
+ + +     + +     +     +     + +   + + + +     + +
+ + + +++++ +++++ + + +++++ + +++ + + + + +++++ + +
+ + +     + +     + + +     + +   + +   +     +   +
+ + +++++ + + +++++++ + +++++++ +++ + +++++++ +++++
+   +     + +   +     + +   +   +   + +       +   +
+++++ +++++ +++ + +++++ + + + +++ +++++ +++++++++ +
+     +     +   + +     + +   + + +   + +         +
+ +++++++++++ +++ + + +++ +++++ + + + + + +++++++ +
+                 + +           +   +     +       +
+++++++++++++++++++++++++++++++++++++++++++++++++++