#########################################
S #                 #       #         # #
# ########### # ### ### ### ##### ### # #
#           # #   #     # # #   #   #   #
########### ##### ####### # # # ### ### #
#         #       #       #   # #   #   #
### ##### ######### # ######### # ### ###
#   # #   #         # #       #   # #   #
# ### # ### ### # ##### # # ####### ### #
# #   # #   #   # #   # # # #     #     #
# # ### ##### ##### # # # ### # ### #####
# #     #     #     #   #     #     #   #
# ##### # ##### ##################### # #
# #   # # #     # #         #         # #
# # # # # # ##### # ##### ### ####### # #
# # # #   # #   #   #   #       #   # # #
# # # ##### # # ##### # ####### # # # # #
#   # #     # #       # #     # # # # # #
# ### # ##### ######### # ### # # # # # #
#   # #   #   #       #   #   # # # # # #
### # ### # ### ##### ##### ### # # # ###
#   #   #   #   #   # #     # #   # #   #
# ##### ######### # # # ##### ##### ### #
#   #       #     # # #     #         # #
# ### ##### # ##### # ##### ########### #
# #   #     # #   #   #   #       #     #
# # ### ##### # # ### # # ####### # ### #
# # # #   #   # #       #     #   #   # #
### # ### # # # ######### ##### ### # ###
#   # #   # # #     #   # #     #   #   #
# ### # ### # ####### # ### ##### ##### #
# # #   #   # #     # #   # #         # #
# # # ####### # ### # ### # ####### ### #
# #         # # # #   #   #     #   #   #
# ######### # # # ##### ####### ### # ###
# #   #       # #   #   #     #   # #   #
# # # ######### ### # ### ### ### ### # #
#   #         #   # #   # #     #   # # #
# ########### ### # ### # # ####### ### #
#           #         #   #             E
#########################################