#########################
S #           #     #   #
# # ######### # # # ### #
#   #       # # # # #   #
##### ##### # ### # # # #
#   #   # #   #   #   # #
# ##### # ##### ####### #
#     #   #     #     # #
# # ##### # ##### # ### #
# #       # #     # #   #
# ######### ##### # # ###
# #   #       #   # # # #
# # # ####### # ### # # #
# # #         # #   # # #
# # ########### # ### # #
# #   #       # #   #   #
# ### # ##### # ####### #
#     #   #     #     # #
####### # ####### ### # #
#     # #     #   #   # #
# # ### ##### # ### # # #
# # #   #   # #   # # # #
# # # ##### # ### # ### #
# #         #     #     E
#########################